10,3,3,3,4,3,3,3,3,4,3,3,3,3,3,3,3,3,3,4,3,3,3,3,3,4,3,3,3,3,4,3,3,3,11
2,0,0,0,2,0,0,0,0,2,0,0,0,0,0,0,0,0,0,2,0,1,1,1,0,2,0,0,0,0,2,1,1,1,2
2,0,0,0,2,0,0,0,0,2,0,0,0,0,0,2,0,0,0,2,0,0,1,0,0,2,0,0,0,0,0,0,2,0,2
2,0,0,0,2,0,0,0,0,7,3,3,3,0,0,2,0,0,0,2,0,0,0,0,0,2,0,0,2,0,0,0,2,0,2
2,0,0,0,2,0,0,0,0,2,0,0,0,0,0,2,0,0,0,2,0,0,0,0,0,2,0,0,2,0,0,0,2,0,2
2,0,0,0,2,0,0,0,0,0,0,0,0,0,0,2,0,0,0,0,0,0,0,0,0,2,0,0,2,0,0,0,2,0,2
2,0,0,0,7,3,3,3,4,3,3,3,0,0,0,2,0,0,0,0,0,0,0,0,0,0,0,0,2,0,0,3,9,0,2
2,0,0,0,2,0,0,0,2,0,0,0,0,0,0,2,0,0,0,0,0,0,0,0,0,0,0,0,2,0,0,0,0,0,2
7,3,3,0,2,0,0,0,2,0,0,0,0,0,0,7,3,3,3,3,3,3,3,0,0,0,0,0,2,0,0,0,0,0,2
2,0,0,0,2,0,0,0,2,0,0,0,0,0,0,2,0,0,0,0,0,0,0,0,0,3,3,3,5,3,3,3,3,3,6
2,0,0,0,2,0,0,0,0,0,0,0,0,0,0,2,0,0,0,0,0,0,0,0,0,0,0,0,0,0,0,0,0,0,2
2,0,3,3,6,0,0,0,0,0,0,0,0,0,0,2,0,0,0,0,0,0,0,0,0,0,0,0,0,0,0,0,0,0,2
2,0,0,0,2,0,0,3,3,3,11,0,0,0,0,0,0,0,0,0,0,2,0,0,0,0,0,0,0,0,0,0,0,0,2
2,0,0,0,2,0,0,0,0,0,2,0,0,0,0,2,0,0,0,0,0,2,0,0,0,0,0,0,0,0,0,0,3,3,6
2,0,0,0,0,0,0,0,0,0,2,0,0,0,0,2,0,0,0,0,0,2,0,0,0,0,0,0,0,0,2,0,0,0,2
2,0,0,0,0,0,0,0,0,0,7,3,0,0,3,6,0,0,0,0,0,2,0,0,0,0,0,0,0,0,2,0,0,0,2
7,3,3,11,0,10,3,3,0,0,2,0,0,0,0,7,3,3,3,3,3,5,3,4,3,3,0,0,0,0,2,0,0,0,2
2,0,0,2,0,2,0,0,0,0,2,0,0,0,0,2,0,0,0,0,0,0,0,2,0,0,0,0,0,0,7,3,3,0,2
2,0,0,2,0,2,0,0,0,0,2,0,0,0,0,2,0,0,0,0,0,0,0,2,0,0,0,0,0,0,2,0,0,0,2
2,0,0,2,0,2,0,0,3,3,6,0,0,0,0,2,0,0,0,2,0,0,0,2,0,0,0,0,0,0,2,0,0,0,2
2,0,0,2,0,0,0,0,0,0,2,0,0,0,0,0,0,0,0,2,0,0,0,2,0,0,0,0,0,0,2,0,0,0,2
2,0,0,0,0,0,0,0,0,0,2,0,0,0,0,0,0,0,0,2,0,0,0,2,0,0,0,0,0,0,2,0,0,0,2
2,0,0,0,0,0,0,0,0,1,2,0,0,0,0,2,0,0,0,2,0,0,0,0,0,0,0,0,0,0,2,0,0,0,2
2,0,0,2,0,2,0,0,1,1,2,0,0,0,0,2,0,0,0,2,0,0,0,0,0,0,0,0,0,0,2,0,0,0,2
8,3,3,5,3,5,3,3,3,3,5,3,3,3,3,5,3,3,3,5,3,3,3,3,3,3,3,3,3,3,5,3,3,3,9
